"filename", "language", "TypeScript JSX", "CSS", "comment", "blank", "total"
"/Users/patrikrasch/Documents/CODE/the-odin-project/113. JavaScript/Finishing-Up-With-JavaScript/top-netcity/src/components/About.tsx", "TypeScript JSX", 1, 0, 0, 0, 1
"/Users/patrikrasch/Documents/CODE/the-odin-project/113. JavaScript/Finishing-Up-With-JavaScript/top-netcity/src/components/AllCommentsOnPost.tsx", "TypeScript JSX", 17, 0, 0, 0, 17
"/Users/patrikrasch/Documents/CODE/the-odin-project/113. JavaScript/Finishing-Up-With-JavaScript/top-netcity/src/components/AllPosts.tsx", "TypeScript JSX", 1, 0, 0, 0, 1
"/Users/patrikrasch/Documents/CODE/the-odin-project/113. JavaScript/Finishing-Up-With-JavaScript/top-netcity/src/components/Comment.tsx", "TypeScript JSX", 15, 0, 14, -1, 28
"/Users/patrikrasch/Documents/CODE/the-odin-project/113. JavaScript/Finishing-Up-With-JavaScript/top-netcity/src/components/DeletePost.tsx", "TypeScript JSX", 92, 0, 1, 11, 104
"/Users/patrikrasch/Documents/CODE/the-odin-project/113. JavaScript/Finishing-Up-With-JavaScript/top-netcity/src/components/Dislikes.tsx", "TypeScript JSX", -2, 0, 0, 0, -2
"/Users/patrikrasch/Documents/CODE/the-odin-project/113. JavaScript/Finishing-Up-With-JavaScript/top-netcity/src/components/DisplayRegister.tsx", "TypeScript JSX", -40, 0, 50, 3, 13
"/Users/patrikrasch/Documents/CODE/the-odin-project/113. JavaScript/Finishing-Up-With-JavaScript/top-netcity/src/components/Header.tsx", "TypeScript JSX", 14, 0, 0, 0, 14
"/Users/patrikrasch/Documents/CODE/the-odin-project/113. JavaScript/Finishing-Up-With-JavaScript/top-netcity/src/components/Likes.tsx", "TypeScript JSX", -2, 0, 0, 0, -2
"/Users/patrikrasch/Documents/CODE/the-odin-project/113. JavaScript/Finishing-Up-With-JavaScript/top-netcity/src/components/LoadingBar.tsx", "TypeScript JSX", -1, 0, 12, 2, 13
"/Users/patrikrasch/Documents/CODE/the-odin-project/113. JavaScript/Finishing-Up-With-JavaScript/top-netcity/src/components/Login.tsx", "TypeScript JSX", 103, 0, 2, 4, 109
"/Users/patrikrasch/Documents/CODE/the-odin-project/113. JavaScript/Finishing-Up-With-JavaScript/top-netcity/src/components/MakeComment.tsx", "TypeScript JSX", 15, 0, 0, 0, 15
"/Users/patrikrasch/Documents/CODE/the-odin-project/113. JavaScript/Finishing-Up-With-JavaScript/top-netcity/src/components/MakePost.tsx", "TypeScript JSX", 2, 0, 0, 0, 2
"/Users/patrikrasch/Documents/CODE/the-odin-project/113. JavaScript/Finishing-Up-With-JavaScript/top-netcity/src/components/People.tsx", "TypeScript JSX", 71, 0, 0, 1, 72
"/Users/patrikrasch/Documents/CODE/the-odin-project/113. JavaScript/Finishing-Up-With-JavaScript/top-netcity/src/components/PeopleUser.tsx", "TypeScript JSX", 1, 0, 0, 0, 1
"/Users/patrikrasch/Documents/CODE/the-odin-project/113. JavaScript/Finishing-Up-With-JavaScript/top-netcity/src/components/Post.tsx", "TypeScript JSX", 36, 0, -4, 1, 33
"/Users/patrikrasch/Documents/CODE/the-odin-project/113. JavaScript/Finishing-Up-With-JavaScript/top-netcity/src/components/Profile.tsx", "TypeScript JSX", 31, 0, 1, 2, 34
"/Users/patrikrasch/Documents/CODE/the-odin-project/113. JavaScript/Finishing-Up-With-JavaScript/top-netcity/src/components/Public.tsx", "TypeScript JSX", -37, 0, 0, 0, -37
"/Users/patrikrasch/Documents/CODE/the-odin-project/113. JavaScript/Finishing-Up-With-JavaScript/top-netcity/src/components/Register.tsx", "TypeScript JSX", -16, 0, 1, 3, -12
"/Users/patrikrasch/Documents/CODE/the-odin-project/113. JavaScript/Finishing-Up-With-JavaScript/top-netcity/src/components/RouteSwitch.tsx", "TypeScript JSX", -4, 0, -4, 0, -8
"/Users/patrikrasch/Documents/CODE/the-odin-project/113. JavaScript/Finishing-Up-With-JavaScript/top-netcity/src/components/ThickSeparatorLine.tsx", "TypeScript JSX", 5, 0, 0, 3, 8
"/Users/patrikrasch/Documents/CODE/the-odin-project/113. JavaScript/Finishing-Up-With-JavaScript/top-netcity/src/components/ThinSeparatorLine.tsx", "TypeScript JSX", 5, 0, 0, 3, 8
"/Users/patrikrasch/Documents/CODE/the-odin-project/113. JavaScript/Finishing-Up-With-JavaScript/top-netcity/src/components/context/EmptyProfilePictureContextProvider.tsx", "TypeScript JSX", -2, 0, 0, 0, -2
"/Users/patrikrasch/Documents/CODE/the-odin-project/113. JavaScript/Finishing-Up-With-JavaScript/top-netcity/src/components/loadingBar.css", "CSS", 0, -49, 84, 1, 36
"/Users/patrikrasch/Documents/CODE/the-odin-project/113. JavaScript/Finishing-Up-With-JavaScript/top-netcity/src/components/login.css", "CSS", 0, -8, 0, -1, -9
"Total", "-", 305, -57, 157, 32, 437