"filename", "language", "TypeScript JSX", "CSS", "comment", "blank", "total"
"/Users/patrikrasch/Documents/CODE/the-odin-project/113. JavaScript/Finishing-Up-With-JavaScript/top-netcity/src/components/About.tsx", "TypeScript JSX", 221, 0, 12, 24, 257
"/Users/patrikrasch/Documents/CODE/the-odin-project/113. JavaScript/Finishing-Up-With-JavaScript/top-netcity/src/components/AllCommentsOnPost.tsx", "TypeScript JSX", 120, 0, 3, 10, 133
"/Users/patrikrasch/Documents/CODE/the-odin-project/113. JavaScript/Finishing-Up-With-JavaScript/top-netcity/src/components/AllPosts.tsx", "TypeScript JSX", 133, 0, 1, 9, 143
"/Users/patrikrasch/Documents/CODE/the-odin-project/113. JavaScript/Finishing-Up-With-JavaScript/top-netcity/src/components/App.tsx", "TypeScript JSX", 16, 0, 39, 13, 68
"/Users/patrikrasch/Documents/CODE/the-odin-project/113. JavaScript/Finishing-Up-With-JavaScript/top-netcity/src/components/Comment.tsx", "TypeScript JSX", 204, 0, 23, 21, 248
"/Users/patrikrasch/Documents/CODE/the-odin-project/113. JavaScript/Finishing-Up-With-JavaScript/top-netcity/src/components/DeletePost.tsx", "TypeScript JSX", 92, 0, 1, 11, 104
"/Users/patrikrasch/Documents/CODE/the-odin-project/113. JavaScript/Finishing-Up-With-JavaScript/top-netcity/src/components/Dislikes.tsx", "TypeScript JSX", 89, 0, 3, 10, 102
"/Users/patrikrasch/Documents/CODE/the-odin-project/113. JavaScript/Finishing-Up-With-JavaScript/top-netcity/src/components/DisplayRegister.tsx", "TypeScript JSX", 5, 0, 51, 13, 69
"/Users/patrikrasch/Documents/CODE/the-odin-project/113. JavaScript/Finishing-Up-With-JavaScript/top-netcity/src/components/Header.tsx", "TypeScript JSX", 99, 0, 0, 8, 107
"/Users/patrikrasch/Documents/CODE/the-odin-project/113. JavaScript/Finishing-Up-With-JavaScript/top-netcity/src/components/Likes.tsx", "TypeScript JSX", 93, 0, 3, 10, 106
"/Users/patrikrasch/Documents/CODE/the-odin-project/113. JavaScript/Finishing-Up-With-JavaScript/top-netcity/src/components/LoadingBar.tsx", "TypeScript JSX", 18, 0, 12, 5, 35
"/Users/patrikrasch/Documents/CODE/the-odin-project/113. JavaScript/Finishing-Up-With-JavaScript/top-netcity/src/components/LoadingScreen.tsx", "TypeScript JSX", 19, 0, 0, 4, 23
"/Users/patrikrasch/Documents/CODE/the-odin-project/113. JavaScript/Finishing-Up-With-JavaScript/top-netcity/src/components/Login.tsx", "TypeScript JSX", 233, 0, 10, 23, 266
"/Users/patrikrasch/Documents/CODE/the-odin-project/113. JavaScript/Finishing-Up-With-JavaScript/top-netcity/src/components/MakeComment.tsx", "TypeScript JSX", 129, 0, 8, 11, 148
"/Users/patrikrasch/Documents/CODE/the-odin-project/113. JavaScript/Finishing-Up-With-JavaScript/top-netcity/src/components/MakeCommentPublic.tsx", "TypeScript JSX", 103, 0, 3, 11, 117
"/Users/patrikrasch/Documents/CODE/the-odin-project/113. JavaScript/Finishing-Up-With-JavaScript/top-netcity/src/components/MakePost.tsx", "TypeScript JSX", 218, 0, 11, 20, 249
"/Users/patrikrasch/Documents/CODE/the-odin-project/113. JavaScript/Finishing-Up-With-JavaScript/top-netcity/src/components/MakePostPublic.tsx", "TypeScript JSX", 96, 0, 38, 16, 150
"/Users/patrikrasch/Documents/CODE/the-odin-project/113. JavaScript/Finishing-Up-With-JavaScript/top-netcity/src/components/People.tsx", "TypeScript JSX", 330, 0, 25, 32, 387
"/Users/patrikrasch/Documents/CODE/the-odin-project/113. JavaScript/Finishing-Up-With-JavaScript/top-netcity/src/components/PeopleUser.tsx", "TypeScript JSX", 370, 0, 45, 34, 449
"/Users/patrikrasch/Documents/CODE/the-odin-project/113. JavaScript/Finishing-Up-With-JavaScript/top-netcity/src/components/Post.tsx", "TypeScript JSX", 535, 0, 17, 43, 595
"/Users/patrikrasch/Documents/CODE/the-odin-project/113. JavaScript/Finishing-Up-With-JavaScript/top-netcity/src/components/Profile.tsx", "TypeScript JSX", 673, 0, 67, 69, 809
"/Users/patrikrasch/Documents/CODE/the-odin-project/113. JavaScript/Finishing-Up-With-JavaScript/top-netcity/src/components/Public.tsx", "TypeScript JSX", 331, 0, 32, 32, 395
"/Users/patrikrasch/Documents/CODE/the-odin-project/113. JavaScript/Finishing-Up-With-JavaScript/top-netcity/src/components/Register.tsx", "TypeScript JSX", 241, 0, 18, 19, 278
"/Users/patrikrasch/Documents/CODE/the-odin-project/113. JavaScript/Finishing-Up-With-JavaScript/top-netcity/src/components/RouteSwitch.tsx", "TypeScript JSX", 48, 0, 5, 7, 60
"/Users/patrikrasch/Documents/CODE/the-odin-project/113. JavaScript/Finishing-Up-With-JavaScript/top-netcity/src/components/SkeletonTheme.tsx", "TypeScript JSX", 11, 0, 8, 2, 21
"/Users/patrikrasch/Documents/CODE/the-odin-project/113. JavaScript/Finishing-Up-With-JavaScript/top-netcity/src/components/ThickSeparatorLine.tsx", "TypeScript JSX", 5, 0, 0, 3, 8
"/Users/patrikrasch/Documents/CODE/the-odin-project/113. JavaScript/Finishing-Up-With-JavaScript/top-netcity/src/components/ThinSeparatorLine.tsx", "TypeScript JSX", 5, 0, 0, 3, 8
"/Users/patrikrasch/Documents/CODE/the-odin-project/113. JavaScript/Finishing-Up-With-JavaScript/top-netcity/src/components/context/AppContextProvider.tsx", "TypeScript JSX", 21, 0, 0, 6, 27
"/Users/patrikrasch/Documents/CODE/the-odin-project/113. JavaScript/Finishing-Up-With-JavaScript/top-netcity/src/components/context/EmptyProfilePictureContextProvider.tsx", "TypeScript JSX", 16, 0, 4, 6, 26
"/Users/patrikrasch/Documents/CODE/the-odin-project/113. JavaScript/Finishing-Up-With-JavaScript/top-netcity/src/components/context/LoadingContextProvider.tsx", "TypeScript JSX", 18, 0, 3, 5, 26
"/Users/patrikrasch/Documents/CODE/the-odin-project/113. JavaScript/Finishing-Up-With-JavaScript/top-netcity/src/components/context/LoggedInUserProfileDataContextProvider.tsx", "TypeScript JSX", 87, 0, 14, 14, 115
"/Users/patrikrasch/Documents/CODE/the-odin-project/113. JavaScript/Finishing-Up-With-JavaScript/top-netcity/src/components/custom-hooks/useCommentData.tsx", "TypeScript JSX", 7, 0, 0, 5, 12
"/Users/patrikrasch/Documents/CODE/the-odin-project/113. JavaScript/Finishing-Up-With-JavaScript/top-netcity/src/components/custom-hooks/useCommentDislikingFunctions.tsx", "TypeScript JSX", 37, 0, 4, 6, 47
"/Users/patrikrasch/Documents/CODE/the-odin-project/113. JavaScript/Finishing-Up-With-JavaScript/top-netcity/src/components/custom-hooks/useCommentLikingFunctions.tsx", "TypeScript JSX", 37, 0, 4, 6, 47
"/Users/patrikrasch/Documents/CODE/the-odin-project/113. JavaScript/Finishing-Up-With-JavaScript/top-netcity/src/components/custom-hooks/useCommentsOnPost.tsx", "TypeScript JSX", 8, 0, 0, 4, 12
"/Users/patrikrasch/Documents/CODE/the-odin-project/113. JavaScript/Finishing-Up-With-JavaScript/top-netcity/src/components/custom-hooks/useDateFunctions.tsx", "TypeScript JSX", 20, 0, 4, 7, 31
"/Users/patrikrasch/Documents/CODE/the-odin-project/113. JavaScript/Finishing-Up-With-JavaScript/top-netcity/src/components/custom-hooks/useInfinityScrollFunctions.tsx", "TypeScript JSX", 38, 0, 4, 8, 50
"/Users/patrikrasch/Documents/CODE/the-odin-project/113. JavaScript/Finishing-Up-With-JavaScript/top-netcity/src/components/custom-hooks/usePostDislikingFunctions.tsx", "TypeScript JSX", 29, 0, 4, 7, 40
"/Users/patrikrasch/Documents/CODE/the-odin-project/113. JavaScript/Finishing-Up-With-JavaScript/top-netcity/src/components/custom-hooks/usePostLikingFunctions.tsx", "TypeScript JSX", 32, 0, 8, 6, 46
"/Users/patrikrasch/Documents/CODE/the-odin-project/113. JavaScript/Finishing-Up-With-JavaScript/top-netcity/src/components/loadingBar.css", "CSS", 0, 35, 84, 2, 121
"Total", "-", 4787, 35, 568, 545, 5935