"filename", "language", "TypeScript JSX", "CSS", "comment", "blank", "total"
"/Users/patrikrasch/Documents/CODE/the-odin-project/113. JavaScript/Finishing-Up-With-JavaScript/top-netcity/src/components/About.tsx", "TypeScript JSX", 198, 0, 12, 20, 230
"/Users/patrikrasch/Documents/CODE/the-odin-project/113. JavaScript/Finishing-Up-With-JavaScript/top-netcity/src/components/AllCommentsOnPost.tsx", "TypeScript JSX", 103, 0, 3, 10, 116
"/Users/patrikrasch/Documents/CODE/the-odin-project/113. JavaScript/Finishing-Up-With-JavaScript/top-netcity/src/components/AllPosts.tsx", "TypeScript JSX", 117, 0, 1, 9, 127
"/Users/patrikrasch/Documents/CODE/the-odin-project/113. JavaScript/Finishing-Up-With-JavaScript/top-netcity/src/components/App.tsx", "TypeScript JSX", 16, 0, 39, 13, 68
"/Users/patrikrasch/Documents/CODE/the-odin-project/113. JavaScript/Finishing-Up-With-JavaScript/top-netcity/src/components/Comment.tsx", "TypeScript JSX", 189, 0, 9, 22, 220
"/Users/patrikrasch/Documents/CODE/the-odin-project/113. JavaScript/Finishing-Up-With-JavaScript/top-netcity/src/components/Dislikes.tsx", "TypeScript JSX", 89, 0, 3, 10, 102
"/Users/patrikrasch/Documents/CODE/the-odin-project/113. JavaScript/Finishing-Up-With-JavaScript/top-netcity/src/components/Header.tsx", "TypeScript JSX", 86, 0, 0, 7, 93
"/Users/patrikrasch/Documents/CODE/the-odin-project/113. JavaScript/Finishing-Up-With-JavaScript/top-netcity/src/components/Likes.tsx", "TypeScript JSX", 93, 0, 3, 10, 106
"/Users/patrikrasch/Documents/CODE/the-odin-project/113. JavaScript/Finishing-Up-With-JavaScript/top-netcity/src/components/LoadingBar.tsx", "TypeScript JSX", 19, 0, 0, 3, 22
"/Users/patrikrasch/Documents/CODE/the-odin-project/113. JavaScript/Finishing-Up-With-JavaScript/top-netcity/src/components/LoadingScreen.tsx", "TypeScript JSX", 19, 0, 0, 4, 23
"/Users/patrikrasch/Documents/CODE/the-odin-project/113. JavaScript/Finishing-Up-With-JavaScript/top-netcity/src/components/Login.tsx", "TypeScript JSX", 111, 0, 8, 16, 135
"/Users/patrikrasch/Documents/CODE/the-odin-project/113. JavaScript/Finishing-Up-With-JavaScript/top-netcity/src/components/MakeComment.tsx", "TypeScript JSX", 114, 0, 8, 11, 133
"/Users/patrikrasch/Documents/CODE/the-odin-project/113. JavaScript/Finishing-Up-With-JavaScript/top-netcity/src/components/MakeCommentPublic.tsx", "TypeScript JSX", 103, 0, 3, 11, 117
"/Users/patrikrasch/Documents/CODE/the-odin-project/113. JavaScript/Finishing-Up-With-JavaScript/top-netcity/src/components/MakePost.tsx", "TypeScript JSX", 201, 0, 11, 20, 232
"/Users/patrikrasch/Documents/CODE/the-odin-project/113. JavaScript/Finishing-Up-With-JavaScript/top-netcity/src/components/MakePostPublic.tsx", "TypeScript JSX", 96, 0, 38, 16, 150
"/Users/patrikrasch/Documents/CODE/the-odin-project/113. JavaScript/Finishing-Up-With-JavaScript/top-netcity/src/components/People.tsx", "TypeScript JSX", 247, 0, 25, 31, 303
"/Users/patrikrasch/Documents/CODE/the-odin-project/113. JavaScript/Finishing-Up-With-JavaScript/top-netcity/src/components/PeopleUser.tsx", "TypeScript JSX", 374, 0, 45, 34, 453
"/Users/patrikrasch/Documents/CODE/the-odin-project/113. JavaScript/Finishing-Up-With-JavaScript/top-netcity/src/components/Post.tsx", "TypeScript JSX", 420, 0, 21, 39, 480
"/Users/patrikrasch/Documents/CODE/the-odin-project/113. JavaScript/Finishing-Up-With-JavaScript/top-netcity/src/components/Profile.tsx", "TypeScript JSX", 632, 0, 66, 67, 765
"/Users/patrikrasch/Documents/CODE/the-odin-project/113. JavaScript/Finishing-Up-With-JavaScript/top-netcity/src/components/Public.tsx", "TypeScript JSX", 368, 0, 22, 32, 422
"/Users/patrikrasch/Documents/CODE/the-odin-project/113. JavaScript/Finishing-Up-With-JavaScript/top-netcity/src/components/Register.tsx", "TypeScript JSX", 214, 0, 17, 14, 245
"/Users/patrikrasch/Documents/CODE/the-odin-project/113. JavaScript/Finishing-Up-With-JavaScript/top-netcity/src/components/RouteSwitch.tsx", "TypeScript JSX", 47, 0, 9, 7, 63
"/Users/patrikrasch/Documents/CODE/the-odin-project/113. JavaScript/Finishing-Up-With-JavaScript/top-netcity/src/components/SkeletonTheme.tsx", "TypeScript JSX", 11, 0, 8, 2, 21
"/Users/patrikrasch/Documents/CODE/the-odin-project/113. JavaScript/Finishing-Up-With-JavaScript/top-netcity/src/components/context/AppContextProvider.tsx", "TypeScript JSX", 21, 0, 0, 6, 27
"/Users/patrikrasch/Documents/CODE/the-odin-project/113. JavaScript/Finishing-Up-With-JavaScript/top-netcity/src/components/context/EmptyProfilePictureContextProvider.tsx", "TypeScript JSX", 18, 0, 4, 6, 28
"/Users/patrikrasch/Documents/CODE/the-odin-project/113. JavaScript/Finishing-Up-With-JavaScript/top-netcity/src/components/context/LoadingContextProvider.tsx", "TypeScript JSX", 18, 0, 3, 5, 26
"/Users/patrikrasch/Documents/CODE/the-odin-project/113. JavaScript/Finishing-Up-With-JavaScript/top-netcity/src/components/context/LoggedInUserProfileDataContextProvider.tsx", "TypeScript JSX", 87, 0, 14, 14, 115
"/Users/patrikrasch/Documents/CODE/the-odin-project/113. JavaScript/Finishing-Up-With-JavaScript/top-netcity/src/components/custom-hooks/useCommentData.tsx", "TypeScript JSX", 7, 0, 0, 5, 12
"/Users/patrikrasch/Documents/CODE/the-odin-project/113. JavaScript/Finishing-Up-With-JavaScript/top-netcity/src/components/custom-hooks/useCommentDislikingFunctions.tsx", "TypeScript JSX", 37, 0, 4, 6, 47
"/Users/patrikrasch/Documents/CODE/the-odin-project/113. JavaScript/Finishing-Up-With-JavaScript/top-netcity/src/components/custom-hooks/useCommentLikingFunctions.tsx", "TypeScript JSX", 37, 0, 4, 6, 47
"/Users/patrikrasch/Documents/CODE/the-odin-project/113. JavaScript/Finishing-Up-With-JavaScript/top-netcity/src/components/custom-hooks/useCommentsOnPost.tsx", "TypeScript JSX", 8, 0, 0, 4, 12
"/Users/patrikrasch/Documents/CODE/the-odin-project/113. JavaScript/Finishing-Up-With-JavaScript/top-netcity/src/components/custom-hooks/useDateFunctions.tsx", "TypeScript JSX", 20, 0, 4, 7, 31
"/Users/patrikrasch/Documents/CODE/the-odin-project/113. JavaScript/Finishing-Up-With-JavaScript/top-netcity/src/components/custom-hooks/useInfinityScrollFunctions.tsx", "TypeScript JSX", 38, 0, 4, 8, 50
"/Users/patrikrasch/Documents/CODE/the-odin-project/113. JavaScript/Finishing-Up-With-JavaScript/top-netcity/src/components/custom-hooks/usePostDislikingFunctions.tsx", "TypeScript JSX", 29, 0, 4, 7, 40
"/Users/patrikrasch/Documents/CODE/the-odin-project/113. JavaScript/Finishing-Up-With-JavaScript/top-netcity/src/components/custom-hooks/usePostLikingFunctions.tsx", "TypeScript JSX", 32, 0, 8, 6, 46
"/Users/patrikrasch/Documents/CODE/the-odin-project/113. JavaScript/Finishing-Up-With-JavaScript/top-netcity/src/components/loadingBar.css", "CSS", 0, 84, 0, 1, 85
"Total", "-", 4219, 84, 400, 489, 5192